     1111
111110000111
110000W00001
 1000000000
  11111111
