    111111
111110000111
11000000001
 10000000E11
 1111111111
