     1111
111110000111
110000W00001
 10000W0001
  11111 11
