    111111
111110000111
110000W00001
 10000000011
 1111111111
