     1111
111110000111
110000W00001
 1000000001
  11111111
