NO ./img/diamond_block.xpm



SO ./img/gold_block.xpm


WE ./img/grass_block.xpm

EA ./img/stone_bricks.xpm


F 176,129,18


C 124,203,249


11111111111111111111111
10000000000000000000031
11100000000000000000301
10000000000000000003001
10000000000000000030001
10000000000000111111111
10000000000000200000001
10000000000000220000001
11111111000000000000001
13333333000W00000000001
11111111111111111111111


11111111111111111111111
10000000000000000000001
11100000000000000000001
10300000000000000000001
10000000000000000000001
10000000000000111111111
10030000000000000000001
10000000000003000000001
11111111000000000000001
10000000000200000000001
11111111111111111111111
