
NO ./img/diamond_block.xpm



SO ./img/gold_block.xpm


WE ./img/grass_block.xpm

EA ./img/stone_bricks.xpm


F 176,129,18


C 124,203,249
         1111
         1001
         1001
         1001
         1001
         1001
         1001
11111111110011111111111
10000000000N20000000001
10000000000020000000001
11111111110011111111111
         1001
         1001
         1001
         1001
         1001
         1001
         1001
         1001
11111111110011111111111
10000000000000000000001
10000000000000000000001
10000000000000000000011
10000000000000000001111
10000000000000000000011
10000000000000000000001
10000000000000000000001
10000000000000000000011
11111111110011111111111
         1001
         1001
         1001
         1001
         1001
         1001
         1001
11111111110011111111111
10000000000000000000001
10000000000000000000001
11111111110011111111111
         1001
         1001
         1001
         1001
         1001
         1001
         1001
         1001
11111111110011111111111
10000000000000000000001
10000000000000000000001
10000000000000000000011
10000000000000000001111
10000000000000000000011
10000000000000000000001
10000000000000000000001
10000000000000000000011
11111111110011111111111
         1001
         1001
         1001
         1001
         1001
         1001
         1001
         1001
11111111110011111111111
10000000000000000000001
10000000000000000000001
10000000000000000000011
10000000000000000001111
10000000000000000000011
10000000000000000000001
10000000000000000000001
10000000000000000000011
11111111111111111111111
