NO ./img/stone.xpm



SO ./img/gold_block.xpm


WE ./img/grass_block.xpm

EA ./img/stone_bricks.xpm



F 176,129,18


C 124,203,249


11111111111111111111111
10000000000000000000001
11100000000000000000001
10000000000000000000001
10000000000000000000001
10000000000000111111111
10000000000000000000001
10000000000000000000001
11111111000000000000001
10000000000E00000000001
11111111111111111111111
