NO ./img/bluestone.xpm



SO ./img/colorstone.xpm


WE ./img/greystone.xpm

EA ./img/redbrick.xpm



F 176,129,18


C 124,203,249


11111111111111111111111
10000000000000000000001
10000000000000000000001
10000000000000000000001
10000000000000000000001
10000000000000000000001
10000000000000000000001
10000000000000000000001
10000000000000000000001
10000000000N00000000001
11111111111111111111111
