NO ./img/diamond_block.xpm



SO ./img/gold_block.xpm


WE ./img/grass_block.xpm

EA ./img/stone_bricks.xpm


F 176,129,18
C 124,203,249

111
101
10111
10N01
11111
  1
